################################################################################
s...#...#.....#.....#...................#...#.......#.......#...........#...#...
###.#.#.#.#.###.###.#.#.###############.#.#.#.###.###.#.#.###.#######.###.#.#.#.
#.#.#.#...#.....#.#...#.#.............#...#.#.#...#...#.#.#...#.....#.#...#...#.
#.#.#######.#####.#####.#######.#.###.#####.#.#.###.###.###.#####.###.#.#######.
#.#.......#...#...#...#.......#.#.#.#.#.#...#.#...#.#.#.........#...#.........#.
#.#######.###.#.###.#.#######.###.#.#.#.#.#######.#.#.#########.###.#########.#.
#.......#.#.....#...#.........#...#.#...#...#.....#.....#.....#.....#...#.....#.
#.###.###.#.#####.#############.###.###.###.#.###.#####.#.###.#####.#.#.#######.
#.#.#.....#...#...#...#.........#.......#...#.#.#.#.#...#.#.#.#.....#.#.........
#.#.#########.#.###.#.#.#.#######.#####.#.###.#.#.#.#.###.#.#.###.###.#########.
#.#.....#.....#...#.#...#.#.....#.#...#.#.#...#.#...#...#.#.#...#.#...#.......#.
#.###.#.#.#######.#######.#.###.#.#.#.###.#.###.###.###.#.#.###.###.###.#####.#.
#...#.#.#.#.....#...#...#.....#.#.#.#.....#...#.....#.#.#.#...#.....#...#...#...
###.#.#.#.#####.###.#.#.#.#####.###.#########.#.#####.#.#.#.#########.#####.####
#...#.#.#.....#...#.#.#.#.#...#...#.#.........#...#...#.#.#.....#.....#.....#...
#.###.#######.###.#.#.#.###.#.###.#.###.#########.#.###.#.###.#.#.#####.###.#.#.
#...#.....#...#...#.#.#.....#.....#...#.........#...#...#...#.#...#.......#...#.
###.#.###.#.###.#.#.#.#########.#####.#.#######.###.#.#####.#####.#######.#####.
#...#...#.......#.#.#...#.......#...#.#.....#.#...#.#.#...#.....#...#.....#.....
#.#####.###########.###.#.#######.#.#.#####.#.###.###.#.#.#####.###.#.#####.####
#.#...#.#...#.....#.#...#...#.....#...#.....#...#.......#.....#.#...#.....#.....
#.#.#.#.#.###.###.#.#.#######.#########.#######.###############.#.#####.#.#####.
#...#.#...#...#.....#.....#...#.....#.......#...#.....#.......#.#.....#.#...#.#.
#####.#####.#############.#.#####.#.#######.#.#.#.###.#.#####.#.#####.#####.#.#.
#...#.....#.............#...#.....#.....#.#.#.#.#.#.#.#.#.....#...#.#...#...#...
#.#.#####.###.#########.#.#####.#######.#.#.#.###.#.#.#.#.#####.#.#.###.#.###.##
#.#.....#...#.#...#.....#.#.....#...#...#.#.#...#.#.....#.#.#...#.#...#...#.#...
#.#####.###.###.#.#.#####.#.#####.###.###.#.###.#.#######.#.#.###.###.#####.###.
#...#.#...#.....#...#...#.#.#.....#...#.......#.#.....#...#.....#...#.........#.
###.#.###.###########.#.#.#.###.#.#.#########.#.#####.#.###########.#.#######.#.
#.#.#...#...#.......#.#...#...#.#.#.#...#...#.#...#...#...#.........#.#.....#.#.
#.#.#.#.###.#.#####.#.#####.#.#.#.#.#.#.#.#.#.#.#.#.#####.#.#########.#.###.#.#.
#.#...#.#.#.#.#...#...#.....#.#.#.....#...#.#...#.#.#.#...#.#...#.....#.#...#...
#.#####.#.#.#.###.#####.#####.#############.###.###.#.#.###.#.#.#.#####.#.######
#.....#...#.#.......#.......#.......#.....#...#.#...#.#.....#.#.#.#...#.#.......
#.#.#.#.###.#######.#######.#######.#.###.###.###.###.#########.#.#.#.###.###.#.
#.#.#.#.#...#.....#...#...#...#.....#.#.....#...#.#.#.......#...#...#...#...#.#.
#.#.###.#.###.###.###.#.#####.#.#####.#.#######.#.#.#.#.###.#.#########.#####.##
#.#.....#.#...#.#.....#.......#.#...#.#.......#...#...#.#...#.........#.....#...
#.#######.#.###.#######.#######.#.#.#.#######.#####.###.#.#########.#.#####.###.
#.#.#.....#.........#...#.......#.#...#...#...#...#.#...#.......#...#.....#...#.
#.#.#.#############.#.###.#######.#####.###.#.#.#.#.#.#########.#.###########.#.
#...#.........#.....#...#.#.....#.#.....#...#.#.#...#.....#...#...#...........#.
#.###########.#.#########.#####.#.###.#.#.#####.#########.#.#####.#.###########.
#.#.....#.....#...#.....#.....#.#...#.#.#.......#.......#.#.......#.....#.......
#.#.###.#.###.###.#.#.#.#####.#.###.###.#########.#####.#.#######.#####.#.#####.
#.#...#.#.#.#.#...#.#.#.......#.........#.........#.......#.....#.....#.#.#...#.
#.###.#.#.#.#.#.#####.#######.###########.#########.#######.###.#####.#.###.#.#.
#.#...#...#.#.#.....#.......#.#.......#...#.........#.........#.....#.#.....#...
#.#.#######.#.#####.#######.#.#.#####.#.###.#########.#############.#.#########.
#.#.#.....#.#.#...#.#.....#.#.#.#...#.#.#.#.#.......#...#...#.......#.#.......#.
#.#.#.###.#.#.#.#.#.#.###.#.###.###.#.#.#.#.#.#####.###.###.#.#######.#####.#.#.
#.#.#...#.#.#...#.#...#.#.#...#...#.#.#.#...#.#.......#.#...#.#.......#...#.#.#.
###.#.###.#.#####.#####.#.#.#.###.#.#.#.#####.#.#######.#.###.#.#######.#.#.#.#.
#...#.#...#.......#.....#.#.#.#.....#.#.#.....#.......#...#...#.#.......#.#.#.#.
#.#.#.#.###.#######.#.###.#.#.#.#####.#.#.#####.#####.###.#.###.#######.#.#.###.
#.#.#.#.#.#.#.....#.#.....#.#.#...#...#...#...#.....#.....#...#...#.....#.#...#.
#.###.#.#.#.#.###.#.#########.###.#.#####.#.#.#####.#########.###.#.#####.###.#.
#.#...#.#.#.#...#.#.#...........#.#.....#.#.#.#...#...#.....#...#...#.........#.
#.#.###.#.#.###.#.#.#.#.#########.#####.#.#.#.#.#.###.#####.###.#############.#.
#...#.#.#.....#.#...#.#...........#.#...#.#.#...#.#.#.....#...#.....#.....#...#.
#.###.#.#####.#.#########.#########.#.#.###.#####.#.#####.#.#.#####.#.###.#.###.
#.#...#...#.#.#.........#.#.........#.#.#...#.....#.....#...#.#...#.#...#.#...#.
#.#.#.###.#.#.#########.#.#.#######.#.###.###.#######.#.###.###.#.#.###.#.#####.
#...#.#...#...#.....#...#.#...#...#.#.#...#.#.#...#...#.#.#.#...#...#...#...#...
#####.#.###.###.#.#.#.###.#####.#.#.#.#.###.#.#.#.#.###.#.#.#.#######.#####.#.##
#...#.#.#.....#.#.#.#.#...#...#.#...#.#.....#...#.#.#.....#.#...#...#.#...#.#.#.
#.#.#.#.#######.#.#.#.###.#.#.#.#####.#####.#####.#.#######.###.#.#.#.#.#.#.#.#.
#.#...#.........#.#.#...#...#...#.........#...#...#.#.....#...#...#...#.#.#.#.#.
#.###############.#.###.#######.#.#########.###.###.#.###.###.#########.###.#.#.
#.#.............#.#...#.#...#...#...#.......#...#.....#.#.....#.....#.....#.#...
#.#.#######.###.#.#####.#.#.#.#####.#.#######.#####.###.#######.###.#####.#.###.
#.#...#...#.#...#...#...#.#.#.#...#.....#...#.....#...#.#.......#.#.....#.#...#.
#.#####.#.###.#####.#.###.###.#.#.#####.###.#####.###.#.#.#.#####.#####.#.###.#.
#...#...#.....#.....#.#.......#.#...#...........#...#.#...#.#.........#...#.#...
###.#.#####.###.###.#.#########.###.#.#############.#.#####.#.#######.###.#.####
#...#.#.....#...#...#.#...#.....#.#.#.#...#.....#...#.....#.#...#.......#.#.....
#.###.#.#####.#######.#.#.#.#####.#.###.#.#.###.#.#######.#.#.#.#########.#.###e
#.....#.....#...........#...#...........#...#.....#.........#.#.............#...
