####################################################################################################
s.#.........#.....#.............#.....#.......#.................#...........#.....#...........#.....
#.###.#####.#.#####.#########.#.#.#.###.###.#.#.###############.#.#######.#.###.#.#.#####.#####.#.#.
#...#...#...#.#.....#...#.....#.#.#.....#...#.#...#.....#.....#...#...#...#.....#.#.....#.....#.#.#.
###.#.#.#.###.#.#######.#.#####.#.#####.#.#######.#.###.#.###.#######.#.#########.#####.#####.#.#.#.
#...#.#.#.....#.........#.#.....#.#...#.#...#.....#.#.#.#...#...#.....#.#.....#.......#.#...#...#.#.
#.#####.#####.#########.#.#.#######.#.#####.#.#####.#.#.###.#.#.###.###.#.###.#########.###.#####.#.
#...#...#.....#.....#...#.#.#.......#.......#...#.....#...#.#.#...#...#.#...#.................#...#.
###.#.#######.#.#.###.###.#.#####.#########.###.#########.#.#.###.###.#.###.###################.###.
#...#.......#.#.#.#...#...#.......#...........#.#.......#.#.#...#...#.#...#.#.......#...........#.#.
#.###.#####.###.#.#.###.###########.###########.#.#####.#.#.###.###.#.#.###.#######.#.###########.#.
#...#...#.#.....#.#...#...........#.#.....#...#.#...#.#.#...#...#.#.#.#.#...#.....#.#.#.............
###.###.#.#######.###.###########.###.###.#.#.#.#.#.#.#.#####.###.#.#.#.#.###.###.#.#.#######.######
#...#.......#...#...#.#...#.....#.......#...#.#.#.#.#.#.....#.#.....#.#.#.#.....#...#.#.....#.#.....
#.#########.#.#####.#.###.#.#.###############.#.###.#.#####.#.###.###.#.#.#.###.###.#.#.###.#.###.#.
#.#.....#.#.#.....#.#...#...#.....#.....#.....#.#...#.......#...#.....#...#.#...#.#.#...#...#.....#.
#.###.#.#.#.#####.#.###.#######.#.#.###.#.###.#.#.###.#########.#####.#####.#.###.#.#####.##########
#.#...#.#.#.....#.#...#...#...#.#.#.#.#.#.#...#.#.#...#.........#...#.#.....#.#.#...#...#.#...#.....
#.#.###.#.#####.#.###.###.#.#.#.###.#.#.#.#.###.#.###.#.#########.#.#.#.#####.#.#.###.###.#.#.#.###.
#.#.#...#.......#...#.......#...#...#.#...#...#.#...#...#...#.....#.#.#.#...#.#...#...#...#.#.....#.
#.#.###.#######.#.###############.###.#######.#.###.#####.#.#######.#.#.###.#.#.###.###.#.#.#######.
#.#...#.#.....#...#.......#.......#...#...#...#...#.#.....#.#.......#.#...#.#.#.....#...#.#...#.....
#.###.#.#.###.#.###.#####.#.#######.###.#.#.#####.#.#.#####.#.#######.###.#.#.#######.#######.#.###.
#.....#...#...#.#...#...#...#...........#.....#.#.#...#.....#.......#...#.#.#.......#.........#.#...
###########.###.#.###.###.#####.#############.#.#.#.###.#####.#####.###.#.#.#######.###########.####
#.....#.#...#...#...#.....#...#...#.....#...#...#.#...#...#.#.....#...#.#.....#...#.....#.......#...
#.###.#.#.###.#####.#.#####.#.###.###.###.#.#####.#####.#.#.#####.###.#.#####.#.#.#.#####.#.#####.#.
#.#.#...#.#.......#.#.....#.#.#.......#...#.......#...#.#.#.#...#.#...#.#...#.#.#.#...#...#.#.....#.
#.#.###.#.#########.#####.#.#.###.#####.###########.#.#.#.#.#.#.#.#.###.#.#.#.###.###.#.###.#.#####.
#.#...#.#.#.......#.....#.#.#...#.#...#...........#.#.#.#.#...#...#.....#.#.........#.#.#.#.#...#.#.
#.#.#.#.#.#.#####.#####.#.#.###.###.#.#.#########.#.#.###.#######.#####.#############.#.#.#.###.#.#.
#.#.#.#.#...#...#.#...#.#.#...#.....#...#...#...#...#...#.......#.#...#.............#.#.#.....#...#.
#.#.###.#######.#.#.#.#.#####.###########.#.#.#.#######.#######.###.#.#############.#.#.#####.###.#.
#.#.......#.....#.#.#...#...#...#...#...#.#...#.....#.....#.....#...#.....#.......#.#.#...#...#...#.
#.#.#######.#.###.#.#####.#.###.#.#.###.#.#########.#####.#.###.#.#######.#.#.###.#.#.###.###.#.###.
#.#.#.......#...#.#.......#.#.....#.....#.....#...#.....#...#...#.......#.#.#.#...#.#...#...#.#.#...
#.#.#.#########.#.#.#######.#.#############.#.#.#######.#####.#########.#.###.###.#.#.#.###.###.#.##
#.#.#.#.#.....#...#.#.#.....#.#...........#.#.#...#...#.#...#.#.......#.#...#...#.#.#.#.#...#...#...
#.###.#.#.###.#####.#.#.#####.#.#########.###.#.#.#.#.#.#.###.#.#####.#.###.###.###.#.#.#.#.#.#####.
#...#.#.#.#.#.........#.......#...#.....#.....#.#...#...#.#.....#.....#.#.#...#...#...#.#.#.#.#...#.
###.#.#.#.#.#####################.#.#.#########.#########.#.###########.#.###.###.###.###.###.#.#.#.
#...#.#.........#...#.............#.#.....#...#...#.....#...#.....#.....#...#.#.....#.#...#...#.#...
#.###.#####.#####.#.#.#############.###.###.#.###.#.###.#.###.###.#.#####.###.#.#####.#.###.###.###.
#...#.....#.#.....#.#.#.......#.......#...#.#...#.#...#.....#...#...#.#.......#...#...#...#.#.#.#...
#.#.#####.###.#####.#.#.#####.#######.###.#.###.#.###.#########.#####.#.#######.#.#.#####.#.#.#.####
#.#.....#.#...#.....#.#.#...#.....#...#.#.....#.#.#.#.#...#.....#...#...#.#...#.#.......#.....#.#...
#######.#.#.###.#####.#.#.#.#####.#.###.#######.#.#.#.#.#.#.#####.#.#.###.#.#.#.#########.#####.#.#.
#.......#...#.#...#...#.#.#.#.....#.#...#...#...#.#...#.#.#.#.....#.#...#...#.......#...#.#...#...#.
#.###########.###.###.#.###.#.#####.###.#.#.#.###.#.###.###.#.###.#####.#.###########.#.###.#.#.###.
#.............#...#...#.....#...#.......#.#...#...#.....#...#...#.....#.#.#.........#.#.....#.#.#...
#.#######.###.#.###.#.#####.###.#########.#####.#######.#.#####.#####.#.#.#.#######.#.#######.#.#.#.
#.#...#.#...#.#...#.#.....#.#...#.........#.....#...#...#...#...#...#...#.#...#...#.#.....#...#.#.#.
#.#.#.#.###.#.###.#.#.#####.#.###.#######.#.#####.###.#####.###.#.#.#########.#.###.#.###.#.#####.#.
#...#.....#.#...#.#.#.#...#.#.#...#.......#...#...#.......#...#.#.#...#.......#...#.#.#...#.....#.#.
#######.###.#####.#.###.#.#.#.#.#.###.#######.###.#.#########.#.#.#.###.#.#####.#.#.#.#.#######.#.##
#.......#...#.....#.#...#...#.#.#...#.......#...#...#.........#.#.#.....#.#.....#...#.#.#.....#.#...
#.#######.#.#.#####.#.#######.#####.###.#######.#####.#########.#.#######.#.#########.#.###.###.###.
#.....#...#.#...#...#.#.....#.....#...#.#.....#.#.....#.....#...#.....#...#.......#...#...#.........
#.#####.###.###.#.#.#.###.#######.#.#.#.#.#.###.#.#####.#####.#########.#########.#.#####.#########.
#.#.....#...#.#.#.#.#.....#.......#.#.#.#.#.#...#...#.#...#...#.......#.#.#.......#.#...#.#...#...#.
###.#####.###.#.###.#.#####.#######.#.#.#.#.#.###.#.#.#.#.#.#####.###.#.#.#.#######.###.#.#.#.###.#.
#...#...#...#.#...#...#...#.#.......#.#.#.#.#.#...#.#.#.#.#.......#.#...#...#.....#.#...#...#...#...
#.###.#.###.#.###.#####.#.#.#########.###.#.#.#####.#.#.#.#########.#####.###.#####.#.#########.###.
#...#.#.....#...#.......#...#.........#...#...#.....#.#.#.........#.....#.#...#.....#.#.......#...#.
###.#.#########.#############.#########.#######.#####.#.#.#######.#.###.#.###.#.#####.#.#####.###.#.
#...#...#...........#.....#...#.......#.#.#...#...#...#.#.#...#...#...#.#...#.#.#.......#...#.#...#.
#.#####.#####.#####.#.###.#.#.#.#####.#.#.#.#.#.#.#.###.#.#.###.#####.#.###.#.#.#.#######.#.#.#.###.
#.#.#...#...#.#...#...#...#.#.#.#...#...#.#.#...#.#.#...#.#.....#.#...#...#.#...#...#...#.#...#.#...
#.#.#.###.#.#.#.#.#####.###.#.#.###.#####.#.#####.#.#.###.#.#####.#.#####.#.#.#######.#.#.###.#.#.##
#.#.#.#...#...#.#.#.....#...#.#...#.......#...#...#.....#.#.#.....#.....#...#.....#...#...#...#.#...
#.#.#.#.#########.#.#####.###.###.#.#.#######.#.#######.#.#.#.#.#######.#########.#.#######.###.###.
#.#.....#.........#...#...#...#...#.#.#.......#.......#.#.#.#.#.....#...#.......#...#...#...#.#...#.
#.#######.#######.###.#####.###.###.#.#.#######.#####.###.#.#####.###.#####.#.#######.###.###.###.#.
#...#...#.......#...#.....#...#.#...#...#.....#.#...#.#...#.......#...#...#.#.....#.....#...#...#.#.
#.#.#.#.#######.###.#####.###.#.#########.###.###.#.#.#.#######.###.###.#.#.#####.#.###.###.#.###.#.
#.#.#.#.......#.#.#...#.#...#.#.........#.#.#.#...#...#.#.......#...#...#.#.#...#...#.#...#...#...#.
#.#.#.#######.#.#.###.#.###.#.#########.#.#.#.#.#######.#.#######.#####.#.#.#.#.###.#.#.#.###.#.###.
#.#.#.#.....#.#.#...#.#...#.#.#.......#...#...#...#...#.#.......#.#.....#.#.#.#...#.#.#.#...#.#.#.#.
#.#.#.#.#.###.#.###.#.###.#.#.#.#.#########.#####.#.#.#.#.#######.#.#####.###.###.#.#.#.#####.#.#.#.
#.#.....#.#...#...#.#.#...#.#...#.#.......#.....#.#.#...#.#.....#.#.#.....#...#.#.#.#.#.......#.#...
#.#########.#####.#.#.#.#.#.###.#.#.###.#.#####.#.#.#######.###.#.#.#.#####.###.#.#.#.#########.#.##
#.#...#.....#...#.#.....#.#...#.#.#...#.#.#...#...#.#.......#.#.#...#.#.......#...#.....#...#...#...
#.###.#.#####.#.#.###.#######.#.#.###.#.#.###.#####.#.#######.#.#####.#####.#.#.#######.#.#.#.#####.
#...#.#.#...#.#.#...#.#.......#.#...#.#.#...#.......#.#.....#.#.....#.....#.#.#...#...#.#.#.#.....#.
###.#.#.#.#.#.#.#.#.###.#######.###.#.#.###.###.#.#.#.#.###.#.#.#########.#.#.###.#.###.#.#######.#.
#.#.#.#...#...#.#.#...#.#...#.....#...#...#...#.#.#.#.#...#.#.#.........#.#.#...#.#.....#.......#.#.
#.#.#.#########.###.#.#.#.#.#####.#######.###.###.###.###.#.#.#########.#.#.###.#.#.#####.###.#.#.##
#.#.#.........#...#.#.....#...#.#.#.....#.#.#.....#...#...#...#.........#.#.#.#.#.#.....#.#...#.#...
#.#.#######.#.###.###########.#.#.#.###.#.#.#####.#.###.#####.#.###.#####.#.#.#.#.#####.###.#.#####.
#.#...#.....#.#.#...#.....#...#.....#...#.#.......#...#.#...#.#...#.#.....#...#.#...#...#...#.#.....
#.###.#.#####.#.###.#.###.#.#############.###########.#.###.#.###.###.#########.###.###.#.###.#.####
#...#.#.#...#.#...#.#.#.#.#...............#...........#...#.....#.....#.........#.#...#.#...#.#.#...
#.#.#.#.#.#.#.###.#.#.#.#.#############.###.###########.#.###############.#######.###.#.###.#.#.#.#.
#.#.#...#.#.#...#.#.#.#.#.....#.........#...#...#.....#.#...#...........#.......#.#...#.#...#.#...#.
###.#####.#.###.#.#.#.#.#####.#.#######.#.###.#.###.#.#####.#.#####.###.#####.#.#.#.###.#.###.#####.
#...#.....#.#...#.#...#.....#.#.#.....#.#.#...#.....#.#...#.....#...#.......#.#.#.#...#.#.#.....#.#.
#.#.#.###.#.#.###.#####.#.###.###.###.###.#.#########.#.#.#####.#.#########.#.#.#.###.#.#.#####.#.#.
#.#.#...#.#.#...#.......#.#...#...#...#...#.#.......#.#.#.#...#.#.....#.#...#.#.#.....#...#...#...#.
#.#####.#.#####.#.#######.#.###.###.###.###.#.###.###.#.#.#.#.#######.#.#.#####.#.#########.#.#####e
#.......#.........#.......#.......#.........#...#.......#...#.........#.........#...........#.......
