################################################################################################################################################################
s.................#.....#...................#.....#...........#.......#.........#.......#...#...#.......#...........#...#...#...#.......................#.......
#################.#.###.#####.#####.#######.#.###.#.#######.#.###.###.#####.###.#.#####.#.###.#.#.#.###.#.#######.#.#.#.#.#.#.#.#.###.#################.#.#####.
#.#.............#.#.#.#.....#.....#.......#...#...#.#.......#...#...#.......#.#.#.#.......#...#...#.#...#...#.....#...#.#.#...#.#...#.....#.......#.....#...#.#.
#.#.#####.#####.#.#.#.#####.#############.#####.###.#.#########.#.#.#########.#.#.#.#####.#.#######.###.###.#.#########.#.#####.###.#####.#.#####.###.#####.#.#.
#...#...#.....#.#...#...#...#.......#.....#.#...#...#...#.....#.#.#.......#...#.#.#.#...#.#...#...#...#.#.#.#.#.....#...#.....#...#.#...#.#.....#...#.#.....#.#.
#.###.#.#####.#.#####.#.#.###.#####.#.#####.#.#########.###.###.###.#####.###.#.#.###.#.#####.#.#.###.#.#.#.#.#.###.#.###.###.###.#.#.###.###.#####.#.#.#####.#.
#.#...#...#...#.......#.#.#...#...#.#.#.....#.#.......#...#.......#.....#...#...#.....#.....#.#.#.#.#.#...#.#.#...#.#...#.#...#...#.#.#...#...#...#.#.#.......#.
#.#.#####.#.###########.#.###.#.#.#.#.###.#.#.###.###.###.#.#####.#######.#.#.###.#########.#.#.#.#.#.###.#.#.###.#.###.###.#####.#.#.#.###.###.#.#.#.#######.#.
#...#.#...#...........#.#...#.#.#.#...#...#.#.....#.#...#.#.#...#.......#.#.#...#.......#.#.....#...#...#.#.#...#.#...#...#.....#.#.#.#.....#.#.#...#...#.....#.
#####.#.#############.#.###.#.###.#####.#.#########.###.#.###.#.#######.###.###.#######.#.#########.###.###.#.###.###.###.#.###.###.#.#######.#.#########.#####.
#.#.....#...#.......#.#.#.#.#...#...#...#.#...........#.#.....#...#...#.....#...#...#.....#...#.......#.#...#.#.....#.#...#...#...#.#.....#...#.#...#.....#.#...
#.#.#####.#.#.###.###.#.#.#.#.#.#.#.#.#####.#######.#.#.#####.###.###.#######.###.#.#######.#.#########.#.###.#.#####.#.#########.#.###.#.#.#.#.#.#.#.#####.#.##
#.#.....#.#...#...#...#...#.#.#.#.#...#...#.....#...#.#.#...#...#...#.......#...#.#...#.....#.........#...#.#...#.....#...#.....#.......#.#.#.#...#.#.#.....#...
#.#####.#######.#.#.#####.#.###.#.#.###.#.#####.#.#####.#.#.###.###.#.#.###.###.#.###.#.#############.###.#.#####.#######.#.###.#########.#.#.#####.#.#.#####.#.
#.....#.........#.#.#.....#.....#.#.#...#.....#.#.......#.#.#.#...#.#.#.#...#.#...#...#...#.........#...#...#.....#.........#...........#...#...#.#...#.#...#.#.
###.###########.###.#.###########.#.#.#####.###.#########.#.#.###.#.###.#.###.#####.#####.#####.#.#####.#####.#####.###################.#######.#.#####.#.#.###.
#...#.........#.#...#.#...........#.#.....#.#...#.....#...#.#.#...#.#...#.......#...#.....#...#.#.....#.......#...#.....#.........#...........#...#.....#.#.....
#.###.###.#####.#.###.#.#########.#.#####.#.#.###.###.#.###.#.#.###.#.###########.###.#.###.#.#######.#####.###.#.#######.#######.#####.#####.###.#####.#.#####.
#.#...#.#.....#.#.#.#.#.....#.#...#...#...#...#...#.#.#.#...#.#...#.#.#...........#...#.....#.#.....#.....#.#...#.#.....#.#.....#.....#.#...#...#.......#.#...#.
#.#.###.#####.#.#.#.#.#####.#.#.#####.#.#######.###.#.#.###.#.###.#.#.#.###########.#########.#.###.###.###.#.###.#.###.#.#####.#####.###.#.###.#########.#.###.
#.#.........#.#.#.#.......#...#...#.#.#.#.......#...#.#...#.#.....#.#...#.......#...#.......#...#.#...#.....#.#.#.#...#.#...#...#...#.....#.#.#.......#...#.....
#.#.#########.#.#.#######.###.###.#.#.#.###.#####.#.#.###.#.#######.###.###.###.#.#####.###.#####.###.#.#####.#.#.###.#.###.#.#.#.#.#######.#.#######.#.###.####
#...#...#.....#.#.......#.#...#.#.#...#...#.#.....#.#.#...#.......#...#.#...#...#.......#.#.....#...#.#.....#.#.#.....#...#.#.#...#.#.....#.#...#.....#.#.......
#.###.#.#.#####.#######.###.###.#.#.#####.#.#######.#.#.#########.###.#.#.###.###########.#####.###.#.#####.#.#.#########.#.#.#####.###.#.#.#.#.#.#####.########
#.#...#.#.#...#.#.....#...#.#...#.#.....#.#.#.......#...#.......#.....#...#...#.....#...#.....#...#.#.....#.#...#.......#.#.#...#.#.....#.#.#.#...#.............
#.#.###.#.#.#.#.###.#.###.#.#.###.#####.#.#.#.#####.#########.#.###########.###.###.#.#.#####.###.#.#####.#####.#.#####.#.#.###.#.###.#####.#####.#####.#######.
#.#...#.#...#.#...#.#...#...#...#.#.....#...#.#...#.#.....#...#...#.......#.#...#...#.#.....#...#...#...#.....#.#.#.....#...#...#...#.#...#.....#.....#.#.....#.
#.###.#.#####.###.###.#.#######.#.#.#########.#.#.#.#.###.#.#####.#.#####.#.###.#.###.#####.###.###.###.#####.#.#.#.#########.###.#.#.#.#.#####.#####.#.###.#.#.
#...#.#.........#.#...#.#.....#.#.#.....#.....#.#.#.#...#.#.#.#...#.#.....#...#.#...#.#.........#...#.......#.#.#.#.#.........#.#.#...#.#.......#.#...#.....#.#.
###.#.###########.#.###.###.#.#.#.#####.#.#.###.###.###.#.#.#.#.###.#.#######.#.###.#.###########.###.#####.#.#.#.#.#.#####.###.#.#####.#########.#.#########.#.
#...#.#.......#...#.#.......#.#.#...#...#.#.#...#.......#...#...#.#.#.......#.#...#...#.....#.....#.....#...#.#.#.#...#...#.#.....#...#.....#.......#...#.....#.
#####.#.#####.#.###.#########.#.###.#.###.#.#.#.#.###########.###.#.#####.###.#.#.#.###.###.#.#########.#.###.#.#.#####.#.#.#.#######.#####.#.#########.#.#####.
#...#...#.....#.#.#.......#.......#.#...#.#.#.#.....#.....#...#...#.....#.#...#.#.#.#...#...#...#.......#...#...#.#.....#...#...#.....#.....#.#.......#.....#...
#.#.#####.#.###.#.#.#####.#######.#.#####.#.#.#######.###.###.#.#.###.###.#.#####.###.###.#####.###.#######.#####.#.###########.#.#.#.#.#####.###.###.#######.#.
#.#.....#.#.#...#.#...#.#.#.....#.#...#...#.#...#.......#...#...#...#.#...#.#...#.#...#.#.......#...#.....#.....#.#.....#...#...#.#.#.#...#.......#.#...#.....#.
#.#####.#.#.#.###.###.#.#.#.###.#.###.#.###.#####.#########.#######.#.#.###.#.#.#.#.###.#########.###.#########.#####.#.#.#.#.#####.#####.#########.###.#.#####.
#.#.....#.#.#...#...#...#...#.#.#...#.#...#.....#.....#.....#.......#.#...#.#.#...#...#...........#.#.......#...#...#.#.#.#...#...#.....#...#...#.....#...#...#.
#.#.#####.#####.#.#####.#####.#.###.#.#.#######.###.###.#########.###.###.#.#.###.###.###.#####.###.#.###.###.###.#.###.#.#####.#.###.#.###.#.#.#.#.#######.###.
#.#.#.#.......#.#.....#...#...#.#...#...#.....#.....#...#...#...#...#.#.#.#.#.#...#.#...#...#...#...#.#...#...#...#.#...#.......#.....#...#.#.#.#.#.....#.....#.
#.#.#.#.#####.#.#####.###.###.#.#########.###.###.###.###.#.#.#.#####.#.#.#.#.#.###.###.#####.###.#.#.#.###.###.#.#.#.#.#######.#########.#.#.###.###.###.###.#.
#.#.#.......#.#.#...#.........#.#.....#...#.....#...#.#...#.#.#.......#.#...#.#.......#.....#...#.#...#...#.#...#.#...#.#.....#.#.....#...#.#.....#...#...#.#.#.
#.#.#######.#.#.#.#.#######.###.#.#.###.#######.#####.#.###.#.#########.#####.#####.#######.#.#.#.#######.#.#####.#####.#.###.###.###.#####.#####.#.#.#.###.#.#.
#.#.......#.#.#.#.#.....#...#...#.#...#.....#.........#...#...#.......#...#...#...#.#.....#.#.#.#.......#.#...#...#.#...#.#.......#...#...#.....#.#.#.#.....#.#.
#.#######.###.#.#.#####.#.###.###.###.#####.###.#########.#####.#.#####.#.#.#.#.#.#.#.###.#.#.#.#######.#.###.#.###.#.###.#########.###.#.#.###.###.#.#####.#.#.
#.#.#.........#...#.....#...#.......#.....#...#.#.........#...#.#.....#.#...#...#.#.#...#...#.#.....#.#.#.....#.#.....#...#...#.........#.#...#...#.#.#...#.#.#.
#.#.#.#############.#######.#############.###.###.#########.#.#.#####.#.#########.#####.#####.#####.#.#.#######.#####.#.###.#.#.#########.#######.#.###.#.#.#.#.
#.#...#.............#.....#.#.....#.......#.#...#...#...#...#.#.#...#.#...#.....#.....#.#.#...#...#.#.#.#...#...#...#.#.....#.#.#...#...#.....#...#.#...#.#.#.#.
#.#####.#################.#.#####.#.#####.#.###.###.#.#.#.###.#.#.#.#.###.###.#.#####.#.#.#.###.###.#.#.#.#.###.#.#.#########.#.#.#.#.#.#####.#.###.#.###.#.#.#.
#.#.....#.......#.......#.#.....#.#...#.......#.....#.#...#.#...#.#.#...#.....#.....#.#.#.#.#...#...#.....#...#...#...#.....#.#.#.#.#.#...#.....#.#...#...#.#...
#.#.###########.#.###.#.#.#####.#.###.###############.#####.#######.###.#########.###.#.#.#.#.#.#.###########.#######.#.###.#.###.#.#.###.#######.#.###.#.#.####
#...#.#.......#...#...#.....#.#...#.#.........#.......#...............#.#.......#.#...#.#.#.#.#.#...#.......#.......#.....#.#...#.#.#...#.....#.#...#.#.#.#.#...
#.###.#.#.###.#####.#######.#.###.#.#########.#.#######.#############.#.#.#.#.###.#.###.#.#.#.#####.#.#####.#######.#####.#.###.#.#.###.#####.#.#.###.#.###.#.##
#...#...#.#.#.....#.#.........#...#.....#.....#...#.#.....#.......#...#...#.#.#...#.....#...#.#.....#...#.#.#.....#.....#.#...#.#.#.....#.....#.#.....#.#...#...
###.#.###.#.#####.#.#####.#####.#####.#.#.###.###.#.#.###.#.#####.#########.###.#########.###.#.#.#####.#.#.#.###.#####.#.#.###.#.#######.#####.#####.#.#.###.#.
#.#.#...#.#.....#.#.#...#.#...#.#.....#.#.#.....#.#.....#.#...#.#.#.......#.#...#...#.....#...#.#.#...#.#.#.#.#.....#...#.#...#.....#...#...#.........#.#.#...#.
#.#.###.#.#.#####.#.#.#.###.#.#.###.###.#.#######.#######.###.#.#.#.#.#.###.#.###.#.#.#####.#.#.###.#.#.#.#.#.#######.#######.#######.#.###.###########.#.###.#.
#...#...#.#.....#.#...#.....#.#.....#...#.........#.....#.......#...#.#.#...#.#...#.........#.#.....#...#.#.#...#...#.#.......#...#...#...#.#.........#.#...#.#.
#.###.###.#####.#.#####.#####.#######.#############.###.#.#######.###.#.#.#.#.#.#####.###############.###.#.#.#.#.#.#.#.#####.###.#.#####.#.#.#######.#.###.###.
#.#...#...#.....#.....#.....#.......#.#.........#...#...#...#...#.#...#.#.#.#.#.#...#.#.............#.....#.#.#...#.#.#.....#.....#.#.....#.......#...#...#...#.
#.#####.###.#########.#.#########.#.#.#####.#.#.###.###.#####.#.###.#####.#.#.###.#.###.###########.#######.#.#####.#.#####.#####.#.#.#############.#####.###.#.
#.#.....#.........#...#.#.......#.#...#...#.#.#...#...#.......#...#...#...#.#.....#...#.....#.....#.#.......#.#.....#...#...#...#.#.#...........#...#.....#...#.
#.#.#######.#####.#.#####.#####.#.#####.#.###.###.###.###########.###.#.#############.#.###.#####.#.#.#######.#.#######.#.###.#.#.#.###########.#.#####.###.###.
#.#.......#.....#...#.....#.....#...#...#.....#.......#.......#.#.....#...#.....#...#.#.#.#.#...#.....#...#...#.......#...#.#.#...#.........#.....#...#.....#...
#.###.###.#####.#######.###.#######.#.#######.#######.#.#####.#.#####.###.#.#.###.#.#.#.#.#.#.#.#######.#.###########.#####.#.#############.#######.#.#.#####.##
#...#...#.#...#.........#...#.....#.#.#.......#.....#.#.#...#.#...#...#.#...#...#.#...#.#.#.#.#...#.....#.........#.......#.#.#...#.......#...#.....#.#.....#...
###.###.#.#.#.###########.###.#####.#.###.#####.###.###.#.#.#.#.###.###.#######.#.#####.#.#.#.###.#.###.#########.#.#####.#.#.#.#.###.#.#.###.#.#####.#####.###.
#.#...#.#...#.#.........#...#.......#...#.#...#...#.....#.#.#.#.....#.....#.....#...#.#.#.#.....#.#...#.......#.....#.......#...#...#.#.#.#...#.....#.....#.....
#.###.#####.#.#####.###.###.#.#########.#.#.#.###.#######.#.#.#.#####.#.#.#.###.###.#.#.#.#######.###.#######.#.#######.###########.#.#.#.#.#.#####.#####.######
#...#.#...#.#.....#...#.#...#.#.........#...#...#.........#.#.#...#...#.#.#.#.....#.#.#...#.......#...#.....#.#.#.....#.#.......#...#.#.#.#.#.....#.#.#...#.....
#.#.#.#.#.#######.#.#.###.###.#####.#.###.###########.#####.#.###.#.###.#.#.#######.#.###.#.#######.###.###.#.###.###.###.#####.#.#####.#.#.###.###.#.#.#.#.###.
#.#.#.#.#.........#.#.....#.#.#...#.#.#.#.#.....#...#.#.....#.#...#...#.#.#.......#.#.....#...#...#.....#.#.#.....#.#.....#...#.#.....#.#.#.#...#...#.#.#.#...#.
###.#.#.###########.#######.#.#.#.#.#.#.#.#.###.#.#.###.#####.###.#####.#.#######.#.###.#####.#.#.#.#####.#.#######.#######.#.#.#####.#.###.#####.###.#.###.###.
#...#.#.......#...#.......#.#...#.#.#.#.#.#.#.#.#.#...#.#...#...#.#.....#.#...#...#...#.#.....#.#.#.#...#.#.#...#...#.....#.#...#...#...#...#...#.#...#.#...#...
#.#.#.#######.#.#.#######.#.#####.###.#.#.#.#.#.#.###.#.#.#.###.#.#.#####.#.###.#####.###.###.#.#.###.#.#.#.#.#.###.#.###.#.###.#.#.###.#.###.#.#.###.#.#.###.#.
#.#.#.........#.#.#.....#.#...........#...#.#.#...#...#...#.#...#...#...#.#.#...#...#.#...#.#.#.#...#.#.#.....#.....#...#.#...#.#.#.....#.....#.......#...#...#.
#.#############.#.#.#.###.#.###############.#.#####.#######.#.#######.#.#.#.#.###.#.#.#.###.#.#.###.#.#.#####.#####.###.#.###.#.#.#########################.###.
#.......#.......#...#.#...#.#.............#.#.......#.....#.#.#...#...#.#...#.....#...#...#...#.#.#.#.#.....#.#...#.#...#.....#.#.....#.........#.........#...#.
#.#.###.#####.#####.###.#####.###########.#.#.#######.#.#.#.#.#.#.#.#######.###########.#.###.#.#.#.#.#####.###.#.#.#.#######.#######.#########.#.#######.###.#.
#.#...#.#.....#...#.#...#.....#.....#...#...#...#.....#.#...#...#.#.#.....#.#...........#...#.#.#...#.#...#...#.#.#.#.#.....#.#.......#...#.....#.#.....#.#...#.
#.###.#.#.#####.#.###.###.#####.###.#.#########.###.###.#########.#.#.#.###.###.#####.#####.#.#.#.###.###.###.#.#.###.#.###.#.#.#####.#.#.#.#####.###.#.#.#.####
#.#...#...#.....#...#.#.........#.#.#.............#...#...#.....#.#...#.......#.#...#...#...#.#.#.....#...#...#.#...#.#...#...#.#...#...#...#...#...#.#.#.#.....
#.#.#####.#.#######.#.#.#########.#.#############.#####.#.#.#####.#.#########.#.#.#.#####.#####.#######.###.###.###.#.#########.#.#.#####.###.#.###.#.###.#####.
#.#.#...#.#.#.....#...#.#.......#.#.#...........#.....#.#.#.....#.#...#.....#.#.#.#.......#.....#...#.....#.....#.#.#.#.........#.#.#.....#...#.#...#.....#...#.
###.#.###.#.#####.#####.###.###.#.#.#.#########.#####.#.#.#####.#.#####.###.#.###.###.#####.#####.###.###.#######.#.#.#.#########.#.###.###.###.#.###.#####.#.#.
#...#.....#.#.........#...#...#...#.#.#.......#.#.#...#.#.#.....#.#.....#.#.#...#...#.#...#...#...#...#.#.....#...#.#...#.#.......#...#.#...#.....#.#...#...#...
#.###.#####.#.###########.#.#.###.#.#.#.###.#.#.#.#.#####.#.#####.#.#####.#.###.###.###.#.#.#.#.###.###.#####.#.#.#.###.#.#.#########.#.#.#########.###.#.######
#.#...#.....#.....#.......#.#.#...#.#.#...#.#.#.#.....#...#.......#.#.#...#...#.....#...#.#.#.#...#.........#...#.#...#...#.#.....#.#.#.#.......#.....#.#.......
#.#####.#####.###.#.#########.#####.#.###.#.#.#.#####.#.#########.#.#.#.#.###.#####.#.###.#.#.###.#########.#####.###.#####.#.###.#.#.#########.###.###.#####.#.
#...#...#...#...#...........#.....#...#.#.#.#.#.....#...#.......#...#...#...#.....#.#.#.#.#.#...#.....#...#...#.....#.....#.....#.#...#...#.....#...#...#...#.#.
###.#.###.#.###############.#####.#####.#.#.#######.#####.#####.#####.###.#######.###.#.#.#####.#.#.###.#.###.#.#########.#######.#.###.#.#.#####.###.###.#.###.
#...#.#...#...........#...#.....#.....#...#.......#.#...#.#...#.....#.#...#.....#...#.#.#.......#.#.....#.....#.........#.........#.....#...#.......#...#.#.....
#.#.#.#.#############.###.#####.###.###.#######.#.#.#.#.#.#.#####.#.###.###.#.#####.#.#.#########.#####################.#####################.#####.###.#.#####.
#.#.#...#.......#...#.#...#...#...#...#...#.#...#.#.#.#...#.#...#.#...#.#...#.....#...#.......#.#.#...#.........#...#...#...........#.....#...#.......#...#.#...
#.#######.#.###.###.#.#.###.#.###.#.#.###.#.#.###.#.#.#####.#.#.#####.#.#.#####.#######.#.###.#.#.#.#.###.#######.#.#.#.###.###.###.#.###.#.###.###########.#.##
#.#.......#.#.......#.#.#...#.....#.#.......#...#.#.#...#...#.#.......#...#.#...#.......#.#.#...#...#.....#.....#.#...#...#...#...#.#...#.#...#...........#...#.
#.#.#######.###.#####.#.#.#################.###.#.#.###.###.#.#.#######.###.#.###.#######.#.#.#######.#####.###.#.#######.#####.#.#.###.#.###.#########.###.###.
#...#.#...#...#.#.....#.#.#.............#...#...#.#.....#...#.#.#.....#...#.#.#...#.#...#.#...#...#...#.....#...#.#...#.#.....#.#.#...#.#...#.#.......#...#.....
#.###.#.#.###.###.#####.#.###.#########.#.###.###########.#.#.###.###.###.#.#.#.###.#.#.#.#####.#.#.###.#####.###.#.#.#.#####.###.###.#.###.#.#####.#.###.#####.
#.#...#.#...#...#.#...#.#.....#...#...#.#...#.......#.....#.#.....#.#...#...#.#.#...#.#.#.....#.#.#...#.#...#.....#.#.#.........#.#.....#...#.....#.#...#.....#.
#.#.#.#.###.###.#.#.#.#.#######.#.#.#.#.###.#######.#.#.###.#######.###.#####.#.#.#.#.#.#####.#.#.###.#.#.#.#.#####.#.#########.#.###############.#####.###.###.
#.#.#.#...#.....#...#.#.....#...#.#.#...#.#.#.....#...#.#...#.........#.#.....#.#.#.#.#.....#.#.#...#.#.#.#.#.#...#.#.......#...#.#.....#.........#.......#.....
#.###.###.#####.#####.#####.#.#.###.#####.#.#.###.#####.#.###.#####.###.#.###.#.#.###.###.#.#.#.#.###.#.#.#.#.#.#.#.#######.#.###.#.###.#.#########.#####.######
#.#.....#...#...#.....#...#...#.#...#.....#.#.#.#...#.#.#.#...#.....#...#.#...#.#...#.#.#.#.#...#.....#.#.#...#.#.......#...#.#...#...#.#...#.......#...#.#.....
#.#.###.###.#####.#####.#.#####.#.#####.#.#.#.#.#.#.#.#.#.###.#.###.#.###.#####.###.#.#.#.#############.#.#####.#########.###.###.#.###.###.#.#######.#.#.#.###.
#...#...#.#.......#.....#.......#.#.....#.#.#...#.#...#.#...#.#...#.#...#.........#.#.#.#...........#...#...#...#...#.....#.....#.#.#.....#.#...#...#.#.#.#...#.
#####.###.#############.#########.#.#######.###.#.#####.###.#####.#.###.#.#######.#.#.#.#####.#####.#.#######.###.#.#.#.#######.#.#.#.###.#.#.#.#.#.#.#.#.#.#.##
#.....#.............#...#.........#.#.......#...#.#.....#...#...#.#.#.#.#...#...#.#.....#...#.#...#.#...#.....#...#.#.#.#.....#.#.#.#...#.#.#.#.#.#...#.#.#.#...
#.#############.###.#.###.#########.#.#####.#####.#.#####.###.#.#.#.#.#.###.#.#.#.#######.#.#.#.#.#.###.#.#####.###.#.###.###.#.#.#.###.#.#.###.#.#####.#.#####.
#.......#.......#.#.#.....#...#.......#...#.......#.#.....#...#...#.#.#...#.#.#.#.........#.#.#.#.#.#.#.....#...#.#.#.....#...#.#.#.#.#.#.#.....#...#...#.#.....
#######.#.#######.#.#.#####.#.#.#######.#.#######.#.#####.###.#####.#.###.#.#.#.###########.#.###.#.#.#######.###.#.#.#####.###.#.#.#.#.#########.#.#.###.#.####
#.....#.#...#...#...#.......#.#.......#.#.....#.#.#.....#...#...#...#.#...#.#.#.....#.#.....#.#...#...#.......#...#.#.....#.#.....#.#.#...#.....#.#.#...#.#.#...
#.###.#.###.###.#.###.#######.#########.#####.#.#.#####.###.###.#.###.#.#####.#####.#.#.#####.#.#####.#.#######.#.#.#####.#.#######.#.###.#.###.#.#.#####.#.#.#.
#...#.#...#.#...#...#.#...#.......#.....#...#.#.....#...#.....#.#.....#.#.........#.#...#.....#.....#.#.....#...#.#.....#.#.......#...#.#.....#.#.#.......#.#.#.
#####.###.#.#.#.###.#.#.#.#######.#.#######.#.#####.#.#######.#.#######.#.#########.#.###.#.###.#.###.#####.#.#.#######.#.#######.###.#.#######.#.#########.#.#.
#.......#...#.#.#...#.#.#...#.....#.#.#.....#.....#.#.....#.#.#...#...#.#.#.........#.#...#.#...#.......#...#.#.#...#...#.#.........#.#.....#...#.....#.....#.#.
#.###########.###.#####.###.#.#####.#.#.#.#.#####.#####.#.#.#.###.#.#.#.#.#.#########.#.###.#######.#####.###.###.#.#.#####.#.#######.#.###.#.#.#####.###.#.#.#.
#.#.........#.....#.....#.#.#.....#.#...#.#.....#.....#.#.#.#.....#.#...#.#.......#...#...#.......#...#...#.#...#.#.#.......#.#.......#.#...#.#.....#...#.#...#.
#.#.#######.#.#####.#####.#.#####.#.#####.#.#########.###.#.#####.#.#####.#######.#.#####.#######.###.#.###.#.#.#.#.#####.#####.#######.#.###.#####.###.#######.
#...#...#.#...#.......#.....#...#.#.....#.#.#.......#.....#.......#.......#.......#.....#.#.....#...#.#.#.#...#...#.#.....#.....#.......#...#.....#...#.......#.
#.###.#.#.###########.#.#####.###.#####.#.###.#.###########.###############.###########.###.###.###.#.#.#.#.#######.#.#####.#####.#####.###.#####.###########.#.
#.#...#.#.............#.....#.#...#.....#.....#.........#...#.......#.....#...#.......#.....#.#.....#.#.#...#.....#.....#...#.....#.#...#.#...#...#...........#.
#.#.#.#.###.###############.#.#.###.#######.#########.#.#.#######.###.###.###.#######.#######.#######.#.#####.###.#.#####.#######.#.#.###.###.#.#.#.###########.
#.#.#.#.#...#.#.........#.#.#.......#.....#.........#.#.#.#.....#.......#...#.......#...........#.....#.#.....#...#.#.....#.....#...#.#.......#.#.#...#.....#...
#.#.#.#.#.###.#.#.#####.#.#.#########.###.#########.#.###.###.#.#######.###.#######.#.#######.#.#.#####.#.#####.#####.#######.#.###.#.#########.#.###.#.###.#.#.
#.#.#.#.#.#.....#...#.....#.....#.....#.#.....#...#.#.....#...#.......#.#.......#...#.#...#...#.#...#...#.#...#.......#.....#.#.#...#.#.......#.#...#...#.#.#.#.
#.###.#.#.#.#######.#.#########.#.#####.#####.#.#.#.#####.#.#########.#.#.#######.###.###.#.###.###.#.###.#.###########.###.#.#.#####.#.#####.#.#########.#.###.
#...#.#.#.#.....#.#.#.#.......#.#...#.......#.#.#...#...#...#.........#.#.#.....#.#...#...#.#...#.#.#.#...#.......#.....#.#...#.....#.#.....#.#.#.........#.....
###.#.#.#.#####.#.#.#.#.###.#.#.#.#.###.#####.#.#####.#.#######.#######.#.#.###.#.#.###.#.#.###.#.#.#.#.#####.###.#.#####.#########.#.#####.#.#.#.###.###.#####.
#.#...#...#.#...#.#.#.#...#.#.#.#.#.#...#.....#.....#.#.......#.....#...#.#...#...#.#...#.#...#...#.#.#.......#...#.#...........#...#...#...#...#.#.#...#.#.....
#.#########.#.###.#.#.###.#.###.###.#.#.#.#########.#.#######.#####.#.###.###.#####.#.###.###.#####.#.#########.###.#.#.#######.#.###.###.#####.#.#.###.###.####
#.........#...#...#.#...#.#...#.#...#.#.#.#...#.#...#.......#...#.#.#.#...#...#.....#.#.#.#...#.....#.....#.....#...#.#.....#...#...#...#...#...#.#...#.....#...
#.#######.#.###.#.#.#####.###.#.#.###.#.#.#.#.#.#.#########.###.#.#.###.###.###.#####.#.#.#.###.#######.###.#####.#.#######.#.#####.###.###.#####.###.#########.
#.#...#...#.#...#.#.....#.#...#...#...#.#...#.#.....#.....#.#.#.#.......#...#.#.......#.#.#.#...#...#.#.....#...#.#.......#.#...#...#...#...#.....#...#.........
#.#.#.#####.###.#.#####.#.#.#########.#.#####.#####.###.###.#.#.#####.###.###.#########.#.#.#.###.#.#.#######.###.#######.#.#####.###.###.#.#.#####.###.#####.#.
#.#.#.......#...#.#...#.#.#...........#...#.#...#.....#...#.#...#...#.#...#...#.....#.....#.#.#...#...#.#.....#...#.......#.....#.....#...#.#.#.......#.#...#.#.
#.#.#########.###.#.###.#.#######.#######.#.###.#####.###.#.#.###.#.###.#####.#.###.#.#####.#.#.#####.#.#.#.#.#.###.###########.#####.#.###.#.#.#####.#.###.#.##
#.#.#...........#...#...#.#.....#.#.....#...#.#...#.#...#.#.#.#...#.....#.....#...#...#.....#...#...#.#...#.#.#.#...#.#.......#.....#.#.#...#.#.#...#.......#...
#.#.#.#########.###.#.###.#.#.#.#.#.###.###.#.###.#.###.#.#.#.###.#########.#####.#####.###.#####.###.#####.###.#.###.#.###.#.#.#.###.#.###.#.#.#.#.#######.###.
#...#.#.......#.#...#.....#.#.#.#.#...#.......#...#.......#.#.....#.......#.....#.#...#.#...#.......#.....#.....#.#...#.#...#...#.#...#...#.#.#.#.#...#.......#.
#.#####.#####.#.###.#########.#.#.#.###########.###########.#########.###.###.#.#.###.#.#.#########.#####.#######.#.###.#.#.#######.#####.#.#.###.###.#########.
#.......#.....#...#.#.........#.#.#.#...#.......#...........#.........#.......#.#.....#.#...............#.........#...#.#.#.#.......#...#.#.#.....#.#...........
#########.#####.#.###.###.###.###.#.#.#.#.#########.#########.#####################.###.###############.###########.#.#.#.###.#######.#.#.#.#######.###########.
#.......#.#...#.#.......#.#...#...#.#.#...#.........#.......#.#...........#.........#...#...........#.......#.....#.#...#.....#.......#...#.#.......#.....#.....
#.#######.#.###.#######.#.###.#.###.#.#####.#.#######.#.###.#.#.#########.#.#########.###.#########.#######.#.#.###.###########.#############.#.#####.###.#.####
#.#...#...#...#.#.....#.#...#.#...#.#...#...#.....#.#.#...#...#.....#...#.#.#.......#.#...#.......#...#.#...#.#.#...#.........#...#...#...#...#...#.....#.#.#...
#.#.#.#.###.#.#.#.###.###.#.#.###.#####.#.#######.#.#.###.#########.#.#.#.#.#.#####.#.#.###.#####.###.#.#.###.#.#.#####.#####.###.#.#.#.#.#.#####.#.#####.#.###.
#...#...#...#...#.#.#...#.#.#...#.......#.....#...#.#.#.#.....#...#.#.#.#...#.#...#...#.#.....#...#.#.#...#...#.#.....#...#.#.#.#.#.#...#.#.#...#...#.#...#...#.
#.#######.#######.#.###.###.###################.###.#.#.#####.#.#.#.#.#.#####.#.###.###.#####.#.###.#.#.###.#########.###.#.#.#.#.#.#####.#.#.#######.#.#####.#.
#.....#...#.....#.#.....#...#...........#.....#...#.#...#...#...#...#.#.....#.#...#.#...#.....#.....#.#.....#.......#.....#.#...#.......#.#.#.........#.#.....#.
#####.#####.###.#.#.#####.#.#.###.#####.#.###.#.#.#.###.###.#########.###.#.#.###.#.#.###.###########.###.###.#.###########.#.###########.#.#####.#####.#.#####.
#...#...#...#.#...#.#.....#.#.#.#...#.#.#.#...#.#.#...#.#.....#.....#.#...#.#...#...#.#.............#...#.#...#.#...........#.#.....#...#.#.#...#.#...#...#.....
#.#.###.#.###.#####.#.#######.#.###.#.#.#.#.#####.#.#.#.#.###.#.###.#.#.#######.###.#.#.###########.###.###.###.#.###.#####.#.#.###.#.#.#.#.#.#.#.#.#.#######.##
#.#.....#...#.....#.#.............#.#.#.#.#.......#.#.#.#.#.#.#...#...#.......#...#.#.#...#.......#...#.....#.#.....#.#.....#.#...#.#.#.#.#...#.#...#.......#...
#.#########.#.#####.#.#############.#.#.#.#########.#.#.#.#.#.###.#######.###.###.#.#.#####.#####.###.#######.#######.#.#####.###.#.#.#.#.#####.#.#####.###.###.
#...#.......#.#.....#.#...#.......#.#.#.#.#.........#.#...#.#.#.....#...#...#.#...#.#.#...#.#...#...#.#.......#.......#.#.#...#...#...#.......#.#...#...#.#.#...
###.#####.###.#.#####.#.###.#####.#.#.#.#.###.###.#########.#.#######.#.#.###.#.#.###.#.#.#.#.#####.#.#.###.###.#.#####.#.#.###.###.###########.###.#.###.#.#.#.
#.#...#...#...#.#...#...#...#...#...#.#.#...#.#.#...........#.#.......#.#.#...#.#.#...#.#...#...#...#...#...#...#.#...#...#...#.#...#.........#...#.#...#.#...#.
#.###.#.###.###.#.#.#####.###.#.#####.#.###.#.#.#########.###.#.#######.###.#.#.###.###.#####.#.#.#######.#.#.#####.#.#######.#.#####.#######.###.#####.#.#####e
#.......#.........#.......#...#.............#...........#.......#...........#.#.........#.....#...........#.#.......#.........#.............#...........#.......
